tilesetIso.png
7 64 32
15 15
2 2 2 2 2 2 6 6 6 2 2 2 2 2 2
2 2 2 2 6 2 2 2 2 2 6 2 2 2 2
2 2 2 2 2 6 4 4 4 6 2 2 2 2 2
2 2 2 6 4 2 2 6 2 2 2 4 6 2 2
2 2 6 4 2 2 6 2 6 2 2 2 4 6 2
2 6 4 2 2 6 2 2 2 2 6 2 2 4 6
6 4 2 2 6 2 2 6 2 2 2 2 2 2 4
2 2 2 6 2 2 2 2 6 2 2 2 2 2 2
2 2 2 2 6 2 2 2 2 6 2 2 2 2 2
2 2 4 2 2 6 2 2 2 2 6 2 2 4 2
2 2 2 4 2 2 6 2 2 2 2 6 4 2 2
2 2 2 2 4 2 2 6 2 2 2 4 2 2 2
2 2 2 2 2 4 4 4 6 2 2 2 2 2 2
2 2 2 2 2 2 6 2 2 6 2 2 2 2 2
2 2 2 2 2 2 2 2 6 2 2 2 2 2 2
0 0 0 0 0 0 0 1 0 0 0 0 0 0 0
0 0 0 0 0 1 0 0 0 0 0 0 0 0 0
0 0 0 0 0 0 0 0 0 1 0 0 0 0 0
0 0 0 0 1 0 0 0 0 0 0 0 0 0 0
0 0 0 0 0 0 0 0 1 0 0 0 0 0 0
0 0 0 1 0 0 0 0 0 0 0 0 0 0 0
0 0 0 0 0 0 0 1 0 0 0 0 0 0 0
0 0 0 0 0 0 0 0 0 0 1 0 0 0 0
0 0 0 0 0 0 0 0 0 0 0 1 0 0 0
0 0 0 0 0 0 0 0 0 0 0 0 1 0 0
0 0 0 0 0 0 0 0 0 0 0 0 0 1 0
0 0 0 0 0 0 0 0 0 0 0 0 0 0 1
0 0 0 0 0 0 0 0 0 0 0 0 0 0 0
0 0 0 0 0 0 0 0 0 0 0 0 0 0 0
